js	javascript
ecmascript	javascript
프런트엔드	프론트엔드
frontend	프론트엔드
front-end	프론트엔드
검색엔진최적화	SEO
cra	react
ts	typescript
COVID19	코로나
k8s	Kubernetes
OS	운영체제
algorism	알고리즘
microservices 마이크로서비스
microservice	마이크로서비스
elasticStack	엘라스틱서치
리액트	react
장고	django
쟝고	django
파이썬	python
파이선	python
파이톤	python
